1,1,1,1,1,1,1,1,1,1,1,1,1,2,2,2,1,1,1,1,1,1,1,2,3,2,1,1,1,1,1,1,1,2,0,2,2,2,2,1,1,2,2,2,4,5,4,3,2,1,1,2,3,0,4,0,2,2,2,1,1,2,2,2,2,4,2,1,1,1,1,1,1,1,2,3,2,1,1,1,1,1,1,1,2,2,2,1,1,1,1,1,1,1,1,1,1,1,1,1#
2,2,2,2,2,1,1,1,1,1,2,0,0,5,2,1,1,1,1,1,2,0,4,4,2,1,2,2,2,1,2,0,4,0,2,1,2,3,2,1,2,2,2,0,2,2,2,3,2,1,1,2,2,0,0,0,0,3,2,1,1,2,0,0,0,2,0,0,2,1,1,2,0,0,0,2,2,2,2,1,1,2,2,2,2,2,1,1,1,1,1,1,1,1,1,1,1,1,1,1#
1,1,1,1,1,1,1,1,1,1,1,1,1,2,2,2,2,1,1,1,1,1,2,2,0,0,2,1,1,1,1,1,2,0,5,4,2,1,1,1,1,1,2,2,4,0,2,2,1,1,1,1,2,2,0,4,0,2,1,1,1,1,2,3,4,0,0,2,1,1,1,1,2,3,3,6,3,2,1,1,1,1,2,2,2,2,2,2,1,1,1,1,1,1,1,1,1,1,1,1#
1,1,1,1,1,1,1,1,1,1,1,1,2,2,2,2,1,1,1,1,1,1,2,5,0,2,2,2,1,1,1,1,2,0,4,0,0,2,1,1,1,2,2,2,0,2,0,2,2,1,1,2,3,2,0,2,0,0,2,1,1,2,3,4,0,0,2,0,2,1,1,2,3,0,0,0,4,0,2,1,1,2,2,2,2,2,2,2,2,1,1,1,1,1,1,1,1,1,1,1#
1,1,1,1,1,1,1,1,1,1,1,1,1,2,2,2,2,2,2,1,1,1,1,2,0,0,0,0,2,1,1,2,2,2,4,4,4,0,2,1,1,2,5,0,4,3,3,0,2,1,1,2,0,4,3,3,3,2,2,1,1,2,2,2,2,0,0,2,1,1,1,1,1,1,2,2,2,2,1,1,1,1,1,1,1,1,1,1,1,1,1,1,1,1,1,1,1,1,1,1#
1,1,1,1,1,1,1,1,1,1,1,1,1,2,2,2,2,2,1,1,1,2,2,2,0,0,5,2,1,1,1,2,0,0,4,3,0,2,2,1,1,2,0,0,3,4,3,0,2,1,1,2,2,2,0,6,4,0,2,1,1,1,1,2,0,0,0,2,2,1,1,1,1,2,2,2,2,2,1,1,1,1,1,1,1,1,1,1,1,1,1,1,1,1,1,1,1,1,1,1#
1,1,1,1,1,1,1,1,1,1,1,1,1,2,2,2,2,1,1,1,1,1,1,2,3,3,2,1,1,1,1,1,2,2,0,3,2,2,1,1,1,1,2,0,0,4,3,2,1,1,1,2,2,0,4,0,0,2,2,1,1,2,0,0,2,4,4,0,2,1,1,2,0,0,5,0,0,0,2,1,1,2,2,2,2,2,2,2,2,1,1,1,1,1,1,1,1,1,1,1#
1,1,1,1,1,1,1,1,1,1,1,2,2,2,2,2,2,2,2,1,1,2,0,0,2,0,0,0,2,1,1,2,0,4,3,3,4,0,2,1,1,2,5,4,3,6,0,2,2,1,1,2,0,4,3,3,4,0,2,1,1,2,0,0,2,0,0,0,2,1,1,2,2,2,2,2,2,2,2,1,1,1,1,1,1,1,1,1,1,1,1,1,1,1,1,1,1,1,1,1#
1,1,1,1,1,1,1,1,1,1,1,2,2,2,2,2,2,1,1,1,1,2,0,0,0,0,2,1,1,1,1,2,0,4,4,4,2,2,1,1,1,2,0,0,2,3,3,2,2,2,1,2,2,0,0,3,3,4,0,2,1,1,2,0,5,0,0,0,0,2,1,1,2,2,2,2,2,2,2,2,1,1,1,1,1,1,1,1,1,1,1,1,1,1,1,1,1,1,1,1#
1,1,1,1,1,1,1,1,1,1,1,2,2,2,2,2,2,2,1,1,1,2,3,3,4,3,3,2,1,1,1,2,3,3,2,3,3,2,1,1,1,2,0,4,4,4,0,2,1,1,1,2,0,0,4,0,0,2,1,1,1,2,0,4,4,4,0,2,1,1,1,2,0,0,2,5,0,2,1,1,1,2,2,2,2,2,2,2,1,1,1,1,1,1,1,1,1,1,1,1#
1,1,1,1,1,1,1,1,1,1,1,1,2,2,2,2,2,1,1,1,1,1,2,0,5,0,2,2,2,1,1,2,2,0,2,4,0,0,2,1,1,2,0,6,3,0,3,0,2,1,1,2,0,0,4,4,0,2,2,1,1,2,2,2,0,2,3,2,1,1,1,1,1,2,0,0,0,2,1,1,1,1,1,2,2,2,2,2,1,1,1,1,1,1,1,1,1,1,1,1#
1,1,1,1,1,1,1,1,1,1,1,1,2,2,2,2,2,2,1,1,1,1,2,0,0,0,0,2,1,1,1,1,2,0,4,0,5,2,1,1,1,1,2,2,6,0,0,2,1,1,1,1,2,0,6,0,2,2,1,1,1,1,2,0,6,0,2,1,1,1,1,1,2,0,6,0,2,1,1,1,1,1,2,0,3,0,2,1,1,1,1,1,2,2,2,2,2,1,1,1#
1,1,1,1,1,1,1,1,1,1,1,1,1,2,2,2,2,1,1,1,1,1,1,2,0,0,2,1,1,1,1,2,2,2,4,0,2,2,1,1,1,2,0,0,6,0,5,2,1,1,1,2,0,0,6,0,0,2,1,1,1,2,0,0,6,0,2,2,1,1,1,2,2,2,6,0,2,1,1,1,1,1,1,2,3,2,2,1,1,1,1,1,1,2,2,2,1,1,1,1#
1,1,1,1,1,1,1,1,1,1,1,2,2,2,2,2,1,1,1,1,1,2,0,0,0,2,2,2,2,2,1,2,0,2,0,2,0,0,0,2,1,2,0,4,0,0,0,4,0,2,1,2,3,3,2,4,2,4,2,2,1,2,3,5,4,0,0,0,2,1,1,2,3,3,0,0,2,2,2,1,1,2,2,2,2,2,2,1,1,1,1,1,1,1,1,1,1,1,1,1#
1,1,1,1,1,1,1,1,1,1,1,1,2,2,2,2,2,2,1,1,1,1,2,0,0,0,0,2,2,1,1,2,2,3,2,2,4,0,2,1,1,2,0,3,3,4,0,0,2,1,1,2,0,0,2,4,0,0,2,1,1,2,0,0,5,0,2,2,2,1,1,2,2,2,2,2,2,1,1,1,1,1,1,1,1,1,1,1,1,1,1,1,1,1,1,1,1,1,1,1#
